R 1920 1080

NO textures/marbface.xpm

SO textures/mountains.xpm

WE textures/metal.xpm

EA textures/brick.xpm

S textures/warrior.xpm

F 220,100,

C 225,30,0

        1111111111111111111111111
        1000000000110000000000001
        1011000001110000002000001
        1001000000000000000000001
111111111011000001110000000000001
100000000011000001110111111111111
11110111111111011100000010001
1111S111111111011101010010001
11000000010101011100000010001
10012222100000000001100000011
10112222110000000000110101001
1100000111010101111101111000111
11110111 1110101 101111010001
11111111 1111111 111111111111
