R 1920 1080

NO textures/marbface.xpm

SO textures/mountains.xpm

WE textures/metal.xpm

EA textures/brick.xpm

S textures/warrior.xpm

C 1,100,1

F 225,222,0

        1111111111111111111111111
        1000000000110000000000001
        1011000001110000002000001
        1001000000000000000000001
111111111011000001110000000000001
100000000011000001110111111111111
11110111111111011100000010001
11111111111110111010100100001
11000000010101011100000010001
10N12222100000000001100000011
10112222110000000000110101001
1100000111010101111101111000111
11110111 1110101 101111010001
11111111 1111111 111111111111
