R 1920 1080

NO textures/marbface.xpm

SO textures/mountains.xpm

WE textures/metal.xpm

EA textures/brick.xpm

S textures/skeleton.xpm

F 220,100,0

C 225,30,0

1111
11S1
1111
