R 1920 1080

NO textures/marbface.xpm

SO textures/mountains.xpm

WE textures/metal.xpm

EA textures/brick.xpm

S textures/warrior.xpm

F 220,100,150

C 225,30,0

11111
11211
111211
121S111
111211
11211
11111
