R 1920 1080

NO textures/doom/marbface.xpm
SO textures/doom/mountains.xpm
WE textures/doom/metal.xpm
EA textures/doom/brick.xpm

S textures/doom/skeleton.xpm
F 220,100,0
C 225,30,0

                                                                      111111111
11111111111111111111111111111111111111111111111111                    100200001
1000000000000000200000000012221000000000000110002111111111111111111111100002001
1000000000002000000000000012221000000000000010200000000000000000000000000000021
10000000020000000000000000000000000000000000000001111111111111111111111000N0201
10000000000012221000000000000000000000000000101001                    100200021
10000000000012221000000000000000000000000001101001                    111111111
11111111111111111111111111111111111111111111111111
